NO maps/xpm/colorstone.xpm
SO maps/xpm/colorstone.xpm
WE maps/xpm/colorstone.xpm
EA maps/xpm/colorstone.xpm

F 128,128,128
C 96,96,96

CT maps/xpm/wood.xpm

POST 5.0,1.0,0.3
POST 5.0,2.0,0.3
POST 5.0,10.0,2.3
POSTT maps/xpm/wredbrick.xpm

111111111111111
100000000000001
100000000000001
100000000000001
100000000000001
100000000000001
100000000000001
100000000000001
100000000000001
100000000000001
100000000000001
1000000N0000001
100000000000001
111111111111111