NO ./path_to_the_north_texture
SO ./path_to_the_south_texture
WE ./path_to_the_west_texture
EA ./path_to_the_east_texture

F 220,100,0
C 225,30,0

11111111111111111
1               1
1   111111111   1
1  10000000001  1
1  10000000001  1
1  [0000N10001  1
1  10001110001  1
1   1111111~1   1
1               1
11111111111111111