NO maps/xpm/bluestone.xpm
SO maps/xpm/bluestone.xpm
WE maps/xpm/greystone.xpm
EA maps/xpm/greystone.xpm

F 128,128,128
C 96,96,96
LINK 0:1
LINK 1:0

11111111111111111111
1000000000000000000P1
10000000000000001111
10000000000000001
10000000N00000001
10000000000000001
10000000000000001
10000000000000001
10111111111111111
101
101
1P1
 1