NO ./path_to_the_north_texture
SO ./path_to_the_south_texture
WE ./path_to_the_west_texture
EA ./path_to_the_east_texture

F 220,100,0
C 225,30,0
LINK 0:1
LINK 1:0
LINK 2:3
LINK 3:2

111111111111111111111111111111
1                            1
1                            1
1   111111111                1
1  10000000001      111      1
1  10000000001      1P1      1
1  10000000001      101      1
1  1001P100001      101      1
1  10011100E01      101      1
1  1001P100001      101      1
1  10000000001      101      1
1  10000000001      1P1      1
1  10000000001      111      1
1   111111111                1
1                            1
1                            1
111111111111111111111111111111