NO ./path_to_the_north_texture
SO ./path_to_the_south_texture
WE ./path_to_the_west_texture
EA ./path_to_the_east_texture

F 220,100,0
C 225,30,0

11111111111111111
1               1
1   111111111   1
1  1000000000]  1
1  10000000001  1
1  10000N00001  1
1  10001110001  1
1   1~11111~1   1
1               1
11111111111111111