NO maps/xpm/colorstone.xpm
SO maps/xpm/colorstone.xpm
WE maps/xpm/colorstone.xpm
EA maps/xpm/colorstone.xpm

F 220,100,0
C 225,30,0
B 3,3
B 4,4
B 5,5
B 10,10
BT maps/xpm/barrel.xpm
P 10,7
P 12,7
PT maps/xpm/pillar.xpm

111111111111111
100000000000001
100000000000001
100000000000001
100000000000001
100000000000001
100000000000001
100000000000001
100000000000001
100000000000001
100000000000001
1000000N0000001
100000000000001
111111111111111